33 16 34 34 34 20 25 08 16 20 25 25 25 25 25 16 
33 00 09 18 10 00 16 24 18 09 20 08 08 25 16 24 
34 24 18 25 16 24 24 32 34 12 17 24 32 20 10 09 
12 09 20 16 32 24 18 08 17 32 20 17 20 17 33 09 
24 12 17 12 25 17 20 17 34 20 17 20 17 20 25 09 
24 32 20 09 33 25 09 33 00 17 20 17 33 10 36 24 
12 25 09 18 36 20 09 33 00 25 09 34 34 20 25 17 
24 34 18 16 33 17 24 20 09 34 32 12 10 10 08 36 
12 10 36 24 33 25 09 18 17 24 20 10 36 20 10 36 
32 33 25 10 16 34 24 34 33 10 17 33 16 24 20 16 
20 25 08 25 00 00 00 00 08 08 08 36 12 17 24 24 
12 25 17 34 32 32 32 32 24 32 18 16 24 20 17 32 
24 20 25 00 08 25 25 08 00 08 08 00 17 12 08 36 
24 12 36 24 12 25 36 24 32 24 24 24 33 09 12 36 
24 24 33 09 18 25 16 18 25 09 18 00 36 24 12 36 
32 32 33 10 25 36 32 33 25 10 36 18 25 17 18 36 
