20 16 20 25 25 25 08 25 25 25 25 16 20 16 20 16 
24 24 24 20 16 20 17 20 25 25 25 17 24 24 24 24 
24 18 17 24 12 10 36 18 25 25 25 16 24 18 17 24 
12 25 25 17 24 20 25 25 25 25 25 09 18 25 16 24 
24 20 25 08 17 24 20 08 25 16 20 17 20 25 09 24 
12 17 20 17 34 24 24 12 16 24 18 16 24 20 17 24 
24 20 10 25 09 24 12 09 32 24 20 17 12 10 16 24 
12 17 20 25 09 24 24 12 16 24 24 20 10 08 17 24 
12 08 10 16 24 24 24 12 17 24 12 17 20 10 36 24 
24 18 16 18 09 24 24 12 16 18 17 20 10 36 20 09 
18 25 10 25 09 12 09 24 24 20 25 09 33 08 09 24 
20 25 25 25 09 24 24 12 09 12 25 17 20 17 24 24 
18 25 16 33 09 18 10 09 18 09 20 16 24 20 17 24 
20 16 12 16 12 25 16 18 25 17 24 24 24 12 25 17 
24 24 24 24 24 33 10 25 25 25 17 18 17 18 25 16 
32 18 17 18 10 25 25 25 25 25 25 25 25 25 25 17 
