20 25 25 25 25 25 25 25 25 25 25 25 25 25 25 16 
24 20 25 25 25 25 25 25 25 25 08 25 25 25 25 09 
24 24 20 25 25 25 08 25 36 33 10 08 25 25 16 24 
24 24 24 34 20 16 18 25 16 34 20 17 20 25 17 24 
24 24 24 12 17 24 20 16 18 09 24 33 10 25 16 24 
24 24 24 18 16 24 24 18 16 18 17 20 25 25 17 24 
24 24 18 25 17 24 24 33 10 25 16 18 25 16 34 24 
24 24 20 16 33 09 24 20 08 16 18 25 25 17 24 24 
24 24 24 18 16 24 24 18 17 18 08 36 20 08 09 24 
24 24 24 20 17 12 17 33 08 16 18 16 24 32 24 24 
24 24 24 18 25 17 20 16 24 18 16 18 00 25 09 24 
24 24 18 25 25 16 24 24 18 16 18 16 18 16 24 24 
24 24 20 25 25 17 24 24 33 10 16 18 16 18 09 24 
12 09 24 33 25 25 09 24 33 25 10 16 18 16 24 24 
24 24 18 25 25 25 17 18 25 25 25 17 33 10 17 24 
32 18 25 25 25 25 25 25 25 25 25 25 25 25 25 17 
