20 25 25 25 25 25 25 25 25 25 25 25 25 25 25 16 
24 20 25 25 36 20 25 25 25 25 25 25 25 25 25 09 
24 24 20 25 16 18 16 20 16 20 16 20 25 25 16 24 
24 24 24 34 18 16 18 17 18 17 24 18 16 20 17 24 
24 24 18 00 36 24 20 16 20 16 24 20 17 18 16 24 
24 24 20 17 20 17 24 18 17 18 17 24 34 20 17 24 
24 24 24 20 17 34 12 25 25 25 25 17 12 00 36 24 
24 24 24 24 20 09 32 20 16 20 25 25 17 32 20 09 
24 24 24 12 17 18 16 18 09 18 25 16 20 08 17 24 
24 24 24 32 20 25 17 33 10 08 36 24 24 32 34 24 
24 24 24 20 17 34 20 25 16 18 16 24 18 25 09 24 
24 24 24 18 25 09 12 36 24 20 09 18 25 16 24 24 
24 24 24 20 25 17 18 16 12 17 32 20 16 24 24 24 
12 09 24 18 25 25 25 17 18 25 25 17 18 17 24 24 
24 24 18 25 25 25 25 25 25 25 25 25 25 25 17 24 
32 18 25 25 25 25 25 25 25 25 25 25 25 25 25 17 
