20 25 25 25 25 25 08 08 25 25 25 08 08 08 08 16 
12 16 20 08 25 36 24 12 16 20 16 32 32 24 24 24 
24 24 24 18 25 16 12 09 12 17 12 08 25 00 09 24 
24 24 18 08 36 24 24 12 17 20 17 12 08 17 24 24 
24 12 36 24 33 09 18 10 25 17 20 09 24 20 17 24 
18 00 36 18 16 32 20 25 25 08 09 24 12 17 20 17 
33 00 25 25 17 20 10 25 25 09 18 00 09 33 09 40 
33 00 36 20 16 12 16 20 16 32 20 09 32 33 10 16 
33 00 36 24 24 24 24 12 17 20 09 32 20 16 20 09 
34 18 16 24 24 18 00 17 20 09 32 20 09 18 17 24 
24 33 10 09 12 16 18 25 17 32 20 09 32 33 25 09 
24 20 36 18 09 24 34 34 20 16 24 24 20 08 25 09 
24 12 36 20 09 18 09 24 24 18 17 12 09 32 33 09 
12 17 20 17 24 34 12 17 24 34 20 17 18 16 33 09 
12 08 10 36 24 24 24 20 17 24 18 16 20 10 08 17 
32 18 25 25 10 10 10 10 25 10 25 10 10 25 10 36 
