20 25 25 25 25 25 25 25 25 25 25 25 25 25 25 16 
24 20 16 20 16 20 25 25 25 25 25 25 08 25 08 09 
12 09 18 17 18 09 34 20 16 20 16 20 17 20 17 24 
24 18 25 25 16 24 12 09 12 09 12 17 20 17 34 24 
18 25 16 20 17 24 24 18 17 18 17 20 17 20 09 24 
20 16 24 18 16 24 12 16 20 25 16 18 25 17 24 24 
24 24 12 36 24 24 32 18 17 20 10 25 08 16 24 24 
24 12 17 20 17 24 34 20 16 12 25 08 09 24 24 24 
24 32 20 17 34 24 12 10 17 32 20 17 24 24 24 24 
18 08 17 20 09 24 12 25 25 25 10 16 24 24 24 24 
33 00 36 24 24 24 18 25 25 25 25 10 09 18 09 24 
33 00 36 24 24 12 25 25 25 25 08 16 32 20 17 24 
33 00 36 24 24 32 20 25 16 20 09 12 16 18 16 24 
20 10 25 17 18 08 10 16 18 17 18 09 18 16 24 24 
12 16 20 16 20 09 33 10 25 25 25 00 25 09 24 24 
32 18 17 18 17 18 25 25 25 25 25 10 25 17 18 17 
