20 36 20 25 25 25 25 25 25 25 25 25 08 16 20 16 
12 25 17 20 08 25 25 25 25 25 25 16 32 24 24 24 
12 36 20 17 24 20 25 08 25 16 33 10 16 18 17 24 
24 33 00 25 17 24 33 00 36 24 20 16 12 25 16 24 
24 33 00 36 20 17 33 00 36 18 17 24 24 33 09 24 
24 20 10 16 18 16 33 00 36 20 16 24 18 16 24 24 
24 12 25 10 16 24 33 00 25 17 24 18 16 24 24 24 
24 18 25 16 24 18 16 12 16 20 17 34 24 24 24 24 
24 20 25 17 24 20 17 18 17 18 16 18 09 24 24 24 
24 18 25 16 18 10 16 20 16 20 17 20 17 24 24 24 
24 20 25 17 20 16 18 17 18 17 34 24 33 09 24 24 
24 12 25 25 17 24 20 08 25 16 18 09 20 17 24 24 
24 12 16 20 16 18 17 18 25 09 20 17 24 34 24 24 
24 24 18 17 12 08 36 20 16 18 10 16 24 12 17 24 
24 24 34 34 32 18 25 17 18 25 25 10 17 24 33 09 
32 18 10 10 25 25 25 25 25 25 25 25 25 10 25 17 
