34 20 36 20 08 08 16 20 08 16 20 08 25 25 25 16 
12 17 33 17 24 24 24 12 09 24 24 24 20 25 16 24 
18 08 08 25 10 09 12 10 17 24 24 24 24 34 24 24 
20 17 18 25 08 00 10 36 33 10 09 24 12 00 09 24 
18 25 08 25 17 18 25 16 20 16 24 24 24 24 24 24 
20 25 10 25 25 25 08 17 24 18 09 18 09 18 17 24 
24 33 08 08 36 34 24 20 17 34 24 34 18 08 25 17 
12 36 24 18 25 09 24 12 16 24 18 10 36 12 25 16 
18 16 24 20 16 24 24 18 17 18 25 25 25 10 25 09 
20 17 24 12 10 17 12 16 20 25 16 20 25 36 20 17 
24 33 10 09 20 25 17 24 24 40 12 10 08 16 18 16 
18 25 16 24 12 25 25 17 12 08 09 40 24 12 08 09 
34 34 24 24 12 25 08 25 10 17 18 25 09 24 18 09 
18 09 24 24 24 20 10 16 20 25 16 40 24 24 40 24 
20 09 12 00 10 10 36 12 09 40 12 25 09 12 16 24 
32 18 17 18 25 25 25 17 18 25 10 25 17 18 10 17 
