20 25 16 20 25 25 25 16 20 25 16 34 34 34 34 34 
24 34 24 24 34 20 36 24 24 33 00 10 10 00 09 24 
24 32 24 24 32 24 33 09 24 33 10 25 16 32 12 09 
24 33 10 17 20 10 25 09 18 25 25 16 12 16 24 24 
24 34 20 25 10 08 36 18 25 25 25 17 32 24 24 24 
24 24 24 20 25 10 25 25 25 36 34 34 34 24 24 24 
12 09 24 18 25 25 25 25 25 08 00 00 00 09 24 24 
24 24 18 08 36 33 16 20 16 32 32 32 24 24 24 24 
24 24 34 18 08 36 24 18 09 20 25 25 17 24 24 24 
32 24 12 16 18 16 12 16 18 10 25 25 25 09 24 24 
34 24 24 18 16 18 09 18 08 25 08 16 34 32 24 24 
24 12 09 40 24 34 18 16 18 16 32 24 12 16 24 24 
24 32 24 34 12 00 36 18 16 18 16 18 17 24 24 24 
24 34 12 00 09 12 16 20 10 16 18 25 25 10 17 24 
12 00 09 32 32 24 32 18 08 10 25 25 08 25 16 24 
32 32 32 33 25 10 25 25 10 25 36 33 10 25 10 17 
