20 08 08 08 08 08 08 08 08 08 08 08 08 08 08 16 
12 00 00 00 00 00 00 00 00 00 00 00 00 00 00 09 
12 00 00 00 00 00 00 00 00 00 00 00 00 00 00 09 
12 00 00 00 00 00 00 00 00 00 00 00 00 00 00 09 
12 00 00 00 00 00 00 00 00 00 00 00 00 00 00 09 
12 00 00 00 00 00 00 00 00 00 00 00 00 00 00 09 
12 00 00 00 00 00 00 00 00 00 00 00 00 00 00 09 
12 00 00 00 00 00 00 00 00 00 00 00 00 00 00 09 
12 00 00 00 00 00 00 00 00 00 00 00 00 00 00 09 
12 00 00 00 00 00 00 00 00 00 00 00 00 00 00 09 
12 00 00 00 00 00 00 00 00 00 00 00 00 00 00 09 
12 00 00 00 00 00 00 00 00 00 00 00 00 00 00 09 
12 00 00 00 00 00 00 00 00 00 00 00 00 00 00 09 
12 00 00 00 00 00 00 00 00 00 00 00 00 00 00 09 
12 00 00 00 00 00 00 00 00 00 00 00 00 00 00 09 
18 10 10 10 10 10 10 10 10 10 10 10 10 10 10 17 