20 25 25 25 25 25 25 25 25 25 25 25 25 25 25 16 
18 08 25 25 25 25 16 20 25 25 25 25 25 25 25 17 
33 00 36 20 25 25 17 18 25 25 16 20 08 25 25 16 
33 00 36 24 20 25 08 36 20 25 17 24 18 08 36 24 
33 00 36 24 18 16 18 16 18 16 20 17 20 09 20 17 
33 00 36 18 16 18 16 24 20 10 17 20 09 24 18 16 
33 00 36 33 10 16 24 18 17 34 20 09 12 17 20 17 
20 09 20 25 16 24 24 20 16 12 17 24 24 20 10 16 
24 24 18 16 24 18 17 18 10 10 25 10 17 18 08 17 
12 00 25 17 24 20 25 16 20 25 16 20 16 33 10 16 
24 12 16 20 09 24 20 17 24 34 24 24 18 25 16 24 
12 09 12 17 24 24 18 16 18 17 24 18 16 20 17 24 
24 12 10 25 00 17 20 10 16 33 00 25 17 18 25 09 
12 17 20 25 17 20 17 20 10 08 17 20 16 20 25 17 
12 16 12 16 20 09 33 10 16 12 25 17 18 10 25 16 
32 18 17 18 17 18 25 25 17 18 25 25 25 25 25 17 
